AND	AH N D
AND(2)	AE N D
DONE	D AH N
EIGHT	EY T
EIGHTY	EY T IY
FIFTY	F IH F T IY
FIVE	F AY V
FOUR	F AO R
FOURTY	F OW Y UH R T IY
HUNDRED	HH AH N D R AH D
HUNDRED(2)	HH AH N D R IH D
HUNDRED(3)	HH AH N ER D
HUNDRED(4)	HH AH N D ER D
NINE	N AY N
NINETY	N AY N T IY
OK	OW K EY
ONE	W AH N
ONE(2)	HH W AH N
SEVEN	S EH V AH N
SEVENTY	S EH V AH N T IY
SIX	S IH K S
SIXTY	S IH K S T IY
TEN	T EH N
THIRTY	TH ER D IY
THREE	TH R IY
TWENTY	T W EH N T IY
TWO	T UW